{
  "width": 10,
  "height": 7,
  "tile_size": 32,
  "tiles": [
    [1, 1, 1, 1, 1, 1, 1, 1, 1, 1],
    [1, 0, 0, 0, 0, 0, 0, 0, 0, 1],
    [1, 0, 0, 0, 0, 0, 0, 0, 0, 1],
    [1, 0, 0, 0, 0, 0, 0, 0, 0, 1],
    [1, 0, 0, 0, 0, 0, 0, 0, 0, 1],
    [1, 0, 0, 0, 0, 0, 0, 0, 0, 1],
    [1, 1, 1, 1, 1, 1, 1, 1, 1, 1]
  ],
  "objects": [
    { "type": "hero", "x": 64, "y": 64 },
    { "type": "zombie", "x": 192, "y": 64 },
    { "type": "coin", "x": 160, "y": 32 }
  ]
}
